122, 2, 444, 50, 522, 572, 1, 1, 1
123, 2, 464, 23, 502, 599, 1, 1, 1
124, 2, 391, 24, 575, 598, 1, 1, 1
125, 2, 412, 25, 554, 597, 1, 1, 1
126, 2, 467, 54, 499, 568, 1, 1, 1
127, 2, 550, 445, 416, 177, 1, 1, 1
