12, 1, 267, 284, 470, 446, 1, 1, 1
13, 1, 337, 326, 445, 336, 1, 1, 1
14, 1, 409, 334, 432, 345, 1, 1, 1
12, 2, 602, 356, 375, 377, 1, 1, 1
13, 2, 728, 384, 363, 353, 1, 1, 1
14, 2, 801, 410, 430, 382, 1, 1, 1
