19, 2, 327, 394, 45, 133, 1, 1, 1
20, 2, 332, 395, 43, 135, 1, 1, 1
21, 2, 335, 403, 42, 130, 1, 1, 1
22, 2, 330, 412, 48, 126, 1, 1, 1
23, 2, 333, 415, 44, 130, 1, 1, 1
24, 2, 341, 415, 40, 125, 1, 1, 1
32, 4, 320, 416, 44, 129, 1, 1, 1
33, 4, 327, 429, 40, 121, 1, 1, 1
34, 4, 335, 436, 28, 109, 1, 1, 1
