165, 2, 1022, 387, 389, 318, 1, 1, 1
166, 2, 1034, 403, 391, 295, 1, 1, 1
167, 2, 1054, 404, 413, 311, 1, 1, 1
168, 2, 1062, 412, 439, 343, 1, 1, 1
169, 2, 1065, 408, 408, 452, 1, 1, 1
170, 2, 995, 513, 490, 389, 1, 1, 1
171, 2, 969, 572, 498, 373, 1, 1, 1
172, 2, 926, 578, 460, 367, 1, 1, 1
173, 2, 899, 568, 455, 368, 1, 1, 1
174, 2, 843, 442, 481, 497, 1, 1, 1
175, 2, 841, 362, 429, 546, 1, 1, 1
