11, 1, 884, 37, 374, 227, 1, 1, 1
12, 1, 820, 64, 343, 241, 1, 1, 1
13, 1, 815, 97, 345, 312, 1, 1, 1
14, 1, 857, 101, 289, 402, 1, 1, 1
15, 1, 933, 140, 237, 359, 1, 1, 1
16, 1, 929, 151, 272, 356, 1, 1, 1
17, 1, 904, 194, 351, 320, 1, 1, 1
18, 1, 877, 238, 414, 280, 1, 1, 1
19, 1, 912, 270, 404, 242, 1, 1, 1
20, 1, 942, 291, 455, 213, 1, 1, 1
