6, 2, 1298, 560, 33, 30, 1, 1, 1
7, 2, 1268, 512, 67, 71, 1, 1, 1
8, 2, 1232, 509, 99, 76, 1, 1, 1
13, 2, 1053, 482, 85, 92, 1, 1, 1
14, 2, 1026, 475, 319, 601, 1, 1, 1
15, 2, 1017, 460, 301, 620, 1, 1, 1
16, 2, 1012, 461, 268, 618, 1, 1, 1
17, 2, 994, 459, 228, 621, 1, 1, 1
18, 2, 973, 446, 232, 634, 1, 1, 1
19, 2, 965, 428, 198, 652, 1, 1, 1
20, 2, 965, 419, 190, 661, 1, 1, 1
21, 2, 965, 415, 179, 665, 1, 1, 1
22, 2, 961, 404, 146, 676, 1, 1, 1
23, 2, 952, 386, 140, 694, 1, 1, 1
24, 2, 943, 373, 143, 707, 1, 1, 1
25, 2, 931, 366, 148, 714, 1, 1, 1
26, 2, 923, 354, 154, 726, 1, 1, 1
27, 2, 919, 335, 153, 745, 1, 1, 1
28, 2, 909, 315, 159, 765, 1, 1, 1
29, 2, 903, 304, 166, 776, 1, 1, 1
30, 2, 895, 295, 166, 785, 1, 1, 1
31, 2, 888, 264, 168, 816, 1, 1, 1
32, 2, 875, 238, 170, 842, 1, 1, 1
33, 2, 869, 223, 180, 857, 1, 1, 1
34, 2, 865, 214, 187, 866, 1, 1, 1
35, 2, 861, 191, 194, 889, 1, 1, 1
36, 2, 854, 155, 201, 925, 1, 1, 1
37, 2, 852, 122, 197, 958, 1, 1, 1
38, 2, 844, 115, 205, 965, 1, 1, 1
39, 2, 850, 84, 196, 996, 1, 1, 1
40, 2, 834, 43, 205, 1037, 1, 1, 1
41, 2, 826, 9, 208, 1071, 1, 1, 1
42, 2, 814, 0, 220, 1080, 1, 1, 1
43, 2, 805, 0, 241, 1080, 1, 1, 1
44, 2, 799, 0, 253, 1080, 1, 1, 1
45, 2, 800, 0, 251, 1080, 1, 1, 1
46, 2, 789, 0, 267, 1080, 1, 1, 1
47, 2, 779, 0, 276, 1080, 1, 1, 1
48, 2, 775, 0, 281, 1080, 1, 1, 1
49, 2, 752, 0, 307, 1080, 1, 1, 1
50, 2, 739, 0, 320, 1080, 1, 1, 1
51, 2, 727, 0, 335, 1080, 1, 1, 1
52, 2, 721, 0, 355, 1079, 1, 1, 1
53, 2, 713, 0, 372, 1080, 1, 1, 1
54, 2, 708, 0, 390, 1080, 1, 1, 1
55, 2, 703, 0, 406, 1080, 1, 1, 1
56, 2, 682, 1, 440, 1079, 1, 1, 1
57, 2, 652, 0, 490, 1080, 1, 1, 1
58, 2, 634, 0, 527, 1080, 1, 1, 1
59, 2, 614, 0, 590, 1080, 1, 1, 1
60, 2, 627, 0, 638, 1080, 1, 1, 1
8, 3, 1258, 611, 49, 46, 1, 1, 1
14, 3, 1113, 862, 33, 175, 1, 1, 1
15, 3, 1084, 771, 40, 270, 1, 1, 1
16, 3, 1034, 611, 186, 417, 1, 1, 1
17, 3, 1020, 616, 132, 414, 1, 1, 1
18, 3, 1008, 609, 99, 442, 1, 1, 1
19, 3, 990, 599, 124, 453, 1, 1, 1
20, 3, 974, 596, 134, 465, 1, 1, 1
21, 3, 952, 584, 139, 477, 1, 1, 1
22, 3, 946, 575, 126, 469, 1, 1, 1
23, 3, 934, 570, 159, 476, 1, 1, 1
24, 3, 927, 569, 145, 477, 1, 1, 1
25, 3, 915, 570, 60, 158, 1, 1, 1
26, 3, 911, 565, 58, 159, 1, 1, 1
27, 3, 907, 562, 56, 148, 1, 1, 1
28, 3, 900, 553, 60, 166, 1, 1, 1
29, 3, 894, 558, 64, 159, 1, 1, 1
30, 3, 893, 550, 58, 176, 1, 1, 1
31, 3, 885, 544, 61, 134, 1, 1, 1
32, 3, 882, 543, 50, 537, 1, 1, 1
33, 3, 886, 537, 48, 121, 1, 1, 1
34, 3, 882, 517, 48, 123, 1, 1, 1
35, 3, 883, 514, 43, 102, 1, 1, 1
36, 3, 871, 513, 53, 76, 1, 1, 1
37, 3, 852, 519, 63, 459, 1, 1, 1
38, 3, 846, 488, 70, 592, 1, 1, 1
39, 3, 834, 487, 69, 592, 1, 1, 1
40, 3, 826, 478, 68, 602, 1, 1, 1
41, 3, 817, 493, 66, 587, 1, 1, 1
42, 3, 809, 476, 73, 604, 1, 1, 1
43, 3, 809, 470, 67, 573, 1, 1, 1
44, 3, 797, 462, 71, 618, 1, 1, 1
45, 3, 789, 458, 73, 621, 1, 1, 1
46, 3, 785, 438, 75, 642, 1, 1, 1
47, 3, 769, 428, 79, 652, 1, 1, 1
48, 3, 762, 415, 91, 665, 1, 1, 1
49, 3, 758, 402, 78, 678, 1, 1, 1
50, 3, 745, 398, 89, 682, 1, 1, 1
51, 3, 726, 387, 115, 693, 1, 1, 1
52, 3, 714, 372, 102, 708, 1, 1, 1
53, 3, 710, 362, 86, 716, 1, 1, 1
54, 3, 693, 351, 79, 729, 1, 1, 1
55, 3, 681, 336, 106, 744, 1, 1, 1
56, 3, 668, 312, 64, 754, 1, 1, 1
57, 3, 653, 305, 94, 775, 1, 1, 1
58, 3, 737, 1000, 38, 80, 1, 1, 1
59, 3, 723, 997, 17, 83, 1, 1, 1
60, 3, 567, 271, 66, 702, 1, 1, 1
28, 4, 1295, 521, 39, 65, 1, 1, 1
29, 4, 1261, 490, 73, 93, 1, 1, 1
30, 4, 1219, 492, 117, 252, 1, 1, 1
31, 4, 1163, 489, 173, 388, 1, 1, 1
32, 4, 1136, 480, 201, 600, 1, 1, 1
33, 4, 1115, 478, 225, 602, 1, 1, 1
34, 4, 1099, 478, 240, 602, 1, 1, 1
35, 4, 1079, 472, 257, 608, 1, 1, 1
36, 4, 1068, 468, 266, 612, 1, 1, 1
37, 4, 1068, 456, 233, 624, 1, 1, 1
38, 4, 1073, 454, 190, 626, 1, 1, 1
39, 4, 1070, 448, 157, 632, 1, 1, 1
40, 4, 1071, 437, 135, 643, 1, 1, 1
41, 4, 1066, 422, 136, 658, 1, 1, 1
42, 4, 1071, 420, 133, 660, 1, 1, 1
43, 4, 1072, 410, 134, 670, 1, 1, 1
44, 4, 1064, 399, 143, 681, 1, 1, 1
45, 4, 1066, 381, 147, 699, 1, 1, 1
46, 4, 1073, 374, 147, 706, 1, 1, 1
47, 4, 1078, 362, 148, 718, 1, 1, 1
48, 4, 1081, 343, 148, 735, 1, 1, 1
49, 4, 1087, 315, 159, 765, 1, 1, 1
50, 4, 1097, 305, 146, 775, 1, 1, 1
51, 4, 1128, 294, 119, 786, 1, 1, 1
52, 4, 1115, 284, 136, 796, 1, 1, 1
53, 4, 1128, 259, 124, 821, 1, 1, 1
54, 4, 1123, 237, 152, 843, 1, 1, 1
55, 4, 1116, 221, 160, 859, 1, 1, 1
56, 4, 1098, 199, 184, 881, 1, 1, 1
57, 4, 1100, 176, 188, 904, 1, 1, 1
58, 4, 1110, 149, 177, 931, 1, 1, 1
59, 4, 1108, 126, 182, 954, 1, 1, 1
60, 4, 1167, 99, 125, 908, 1, 1, 1
45, 6, 1365, 163, 50, 147, 1, 1, 1
46, 6, 1306, 148, 111, 312, 1, 1, 1
47, 6, 1232, 144, 190, 625, 1, 1, 1
48, 6, 1152, 128, 270, 927, 1, 1, 1
49, 6, 1072, 103, 356, 977, 1, 1, 1
50, 6, 1027, 80, 396, 1000, 1, 1, 1
51, 6, 972, 71, 452, 1009, 1, 1, 1
52, 6, 927, 39, 477, 1041, 1, 1, 1
53, 6, 934, 10, 365, 1070, 1, 1, 1
54, 6, 809, 37, 445, 1043, 1, 1, 1
55, 6, 756, 0, 410, 1080, 1, 1, 1
56, 6, 695, 0, 412, 1080, 1, 1, 1
57, 6, 665, 0, 102, 221, 1, 1, 1
58, 6, 648, 2, 92, 1078, 1, 1, 1
59, 6, 598, 1, 170, 1079, 1, 1, 1
60, 6, 576, 0, 192, 1080, 1, 1, 1
