17, 9, 1846, 125, 42, 137, 1, 1, 1
18, 9, 1842, 126, 53, 222, 1, 1, 1
19, 9, 1857, 119, 49, 216, 1, 1, 1
20, 9, 1876, 164, 30, 175, 1, 1, 1
21, 9, 1883, 290, 23, 47, 1, 1, 1
