7, 1, 133, 213, 260, 116, 1, 1, 1
8, 1, 141, 218, 200, 119, 1, 1, 1
9, 1, 143, 199, 256, 122, 1, 1, 1
10, 1, 142, 177, 252, 109, 1, 1, 1
11, 1, 136, 186, 248, 105, 1, 1, 1
12, 1, 126, 204, 260, 99, 1, 1, 1
13, 1, 126, 199, 273, 91, 1, 1, 1
14, 1, 124, 140, 266, 147, 1, 1, 1
15, 1, 129, 147, 230, 147, 1, 1, 1
16, 1, 120, 147, 268, 157, 1, 1, 1
